000000000000000000000000000000000000000000000000000000000001111
000000000000000000000000000000000000000000000000000000000001111
111111111111111111111111111111111111111111111111111111111111111
000000000000000000000000000000000000000000000000000000000001111
111111111111111111111111111111111111111111111111111111111111111
000000000000000000000000000000000000000000000000000000000001111
000000000000000000000000000000000000000000000000000000000001111
100000000000000000000000000000000000000000000000000000000000111
100000000000000000000000000000000000000000000000000000000000000
100000000000000000000000000000000000000000000000000000000000111
100000000100000000000000000000000000000000000000000000000000001
000000000000000000000000000000000000000000000000000000000000010
000000000000000000000000000000000000000000000000000000000000010
000000000000000000000000000000000000000000000000000000000000110
000000000000000000000000000000000000000000000000000000000000220
000000000000000000000000000000000000000000000000000000000000012
000000000000000222000000000000000000000000000000000000000000022
000000000000000000000000000000000000000000000000000000000000221
000000000000000000000000000000000000000000000000000000000000000
000000000000000000000000000000000000000000000000000000000000002
000000000000000000000000000000000000000000000000000000000000221
000000000000000000000000000000022200000000000000000000000000200
000000000000000000000000000000000000000000000000000000000000111
000000000000000000000000000000000000000000000000000000000000000
000000000100000000000000000000000000000000000000000000000000110
000000000000000000000000000000000000000000000000000000000000012
000000000000000000000000000000000000000000000000000000000000000
000000000000000000000000000000000000000000000000000000000000111
000000000000000000000000000000000000000000002220000000000000111
000000000000000000000000000000000000000000000000000000000000111
000000000000000000000000000000000000000000000000000000000000111
000000000000000000000000000000000000000000000000000000000000111
000000001111111122211100000000000000000000000000000000000000001
000000000000000000000000000000000000000000000000000000000000001
00000000000000p000000000000000000000000000000000000000000000001
000000000000000000000000000000000000000000000000000000000000001
000000000000000000000000000000000000000000000000000000000000001
000000000000000000000000000000000002220000000000000000000000011
000000000000000000000000000000000000000000000000000000000000001
000000000000000000000000000000000000000000000000000000000000001
